1,1,1,1,1,1,1,1,1,1,1,1,1,1,1
1,0,0,0,1,0,0,0,0,0,0,0,33,0,1
1,1,1,0,1,1,0,1,1,1,1,0,0,0,1
1,0,1,0,0,0,0,0,0,0,1,0,1,0,1
1,0,0,1,0,1,1,1,1,0,0,0,1,0,1
1,0,0,0,0,0,1,0,0,0,1,0,1,0,1
1,0,1,0,1,0,0,0,1,1,1,1,0,0,1
1,22,0,0,1,0,0,0,0,0,0,0,0,0,1
1,1,1,0,1,0,1,0,1,0,1,0,1,0,1
1,0,0,0,0,0,0,0,0,0,1,0,0,0,1
1,0,1,0,1,1,1,0,0,0,1,1,0,0,1
1,0,1,0,1,0,0,0,1,0,1,0,0,0,1
1,0,1,1,1,0,0,1,1,0,1,0,0,1,1
1,0,0,0,0,0,0,0,0,0,1,0,0,0,1
1,1,1,1,1,1,1,1,1,1,1,1,1,1,1
